[
  [1 ,1 ,1 ,1 ,1 ,1 ,1 ,1 ,1 ,1 ,1 ,1 ,1 ,1 ,1 ,1 ,1 ,1 ,1 ,1 ,1 ,1 ,1 ,1 ,1 ,1 ,1 ,1 ,1 ,1 ,1 ,1 ,1 ,1 ,1 ,1 ,1 ,1 ,1 ,1 ,1 ,1 ,1 ,1 ,1 ,1 ,1 ,1 ],
  [1 ,1 ,1 ,1 ,1 ,1 ,1 ,1 ,1 ,1 ,2 ,2 ,2 ,2 ,2 ,2 ,2 ,2 ,2 ,2 ,2 ,2 ,2 ,1 ,1 ,1 ,1 ,1 ,1 ,1 ,1 ,1 ,1 ,1 ,1 ,1 ,1 ,1 ,1 ,1 ,1 ,1 ,1 ,1 ,1 ,1 ,1 ,1 ],
  [1 ,1 ,1 ,1 ,1 ,1 ,1 ,1 ,1 ,1 ,2 ,2 ,2 ,2 ,2 ,2 ,2 ,2 ,2 ,2 ,2 ,2 ,2 ,1 ,1 ,1 ,1 ,1 ,1 ,3 ,3 ,12,1 ,1 ,1 ,1 ,1 ,1 ,1 ,2 ,2 ,1 ,1 ,1 ,1 ,1 ,1 ,1 ],
  [1 ,1 ,1 ,1 ,1 ,1 ,1 ,1 ,1 ,1 ,3 ,2 ,1 ,1 ,1 ,1 ,1 ,1 ,8 ,8 ,8 ,8 ,8 ,3 ,1 ,1 ,1 ,1 ,9 ,3 ,2 ,2 ,2 ,2 ,1 ,1 ,4 ,2 ,2 ,2 ,2 ,2 ,2 ,2 ,1 ,1 ,1 ,1 ],
  [1 ,1 ,1 ,1 ,1 ,1 ,1 ,1 ,1 ,3 ,3 ,2 ,2 ,1 ,1 ,1 ,1 ,2 ,2 ,2 ,2 ,2 ,2 ,3 ,3 ,1 ,1 ,1 ,1 ,9 ,10,2 ,2 ,2 ,2 ,2 ,2 ,2 ,2 ,2 ,2 ,3 ,2 ,2 ,1 ,1 ,1 ,1 ],
  [1 ,1 ,1 ,1 ,1 ,1 ,1 ,1 ,1 ,3 ,2 ,2 ,2 ,2 ,1 ,1 ,1 ,2 ,2 ,2 ,2 ,2 ,2 ,2 ,10,13,1 ,1 ,1 ,10,2 ,2 ,2 ,2 ,2 ,2 ,2 ,3 ,2 ,2 ,1 ,14,14,14,1 ,1 ,1 ,1 ],
  [1 ,1 ,1 ,1 ,1 ,1 ,1 ,1 ,1 ,1 ,2 ,2 ,2 ,2 ,1 ,1 ,1 ,1 ,3 ,2 ,2 ,2 ,2 ,2 ,10,9 ,1 ,1 ,1 ,1 ,1 ,2 ,2 ,2 ,2 ,3 ,1 ,1 ,1 ,1 ,1 ,3 ,3 ,13,1 ,1 ,1 ,1 ],
  [1 ,1 ,1 ,1 ,1 ,1 ,1 ,1 ,1 ,1 ,1 ,2 ,2 ,2 ,1 ,1 ,1 ,5 ,3 ,3 ,2 ,1 ,1 ,2 ,10,10,1 ,1 ,1 ,1 ,1 ,2 ,2 ,2 ,3 ,1 ,1 ,1 ,1 ,1 ,1 ,3 ,3 ,3 ,13,1 ,1 ,1 ],
  [1 ,1 ,1 ,1 ,1 ,1 ,1 ,1 ,1 ,2 ,2 ,2 ,2 ,2 ,1 ,1 ,1 ,3 ,3 ,3 ,2 ,1 ,1 ,2 ,2 ,2 ,1 ,1 ,1 ,1 ,1 ,2 ,2 ,2 ,1 ,1 ,1 ,1 ,1 ,3 ,3 ,13,13,3 ,3 ,1 ,1 ,1 ],
  [1 ,1 ,1 ,2 ,2 ,1 ,1 ,1 ,2 ,2 ,2 ,2 ,2 ,4 ,1 ,1 ,1 ,3 ,2 ,2 ,2 ,2 ,2 ,2 ,2 ,2 ,1 ,1 ,1 ,1 ,3 ,2 ,2 ,1 ,1 ,1 ,1 ,1 ,1 ,13,13,3 ,3 ,3 ,3 ,3 ,1 ,1 ],
  [1 ,1 ,2 ,2 ,2 ,1 ,1 ,2 ,2 ,2 ,2 ,1 ,1 ,1 ,1 ,1 ,1 ,2 ,2 ,2 ,10,2 ,2 ,2 ,2 ,2 ,1 ,1 ,1 ,1 ,3 ,2 ,2 ,2 ,2 ,1 ,1 ,1 ,1 ,1 ,13,13,13,3 ,3 ,3 ,1 ,1 ],
  [1 ,1 ,3 ,3 ,2 ,2 ,2 ,2 ,2 ,2 ,1 ,1 ,1 ,1 ,1 ,1 ,1 ,2 ,2 ,10,9 ,1 ,1 ,2 ,2 ,2 ,1 ,1 ,1 ,1 ,3 ,2 ,1 ,2 ,2 ,1 ,1 ,1 ,1 ,1 ,1 ,13,13,3 ,13,1 ,1 ,1 ],
  [1 ,1 ,3 ,2 ,2 ,2 ,2 ,2 ,2 ,1 ,1 ,1 ,1 ,1 ,1 ,2 ,2 ,2 ,10,9 ,1 ,1 ,1 ,2 ,2 ,2 ,1 ,1 ,1 ,1 ,2 ,2 ,1 ,2 ,2 ,2 ,1 ,1 ,1 ,3 ,1 ,1 ,1 ,13,3 ,1 ,1 ,1 ],
  [1 ,1 ,2 ,2 ,1 ,1 ,1 ,1 ,2 ,1 ,1 ,1 ,1 ,1 ,2 ,2 ,2 ,2 ,2 ,1 ,1 ,1 ,1 ,3 ,2 ,2 ,1 ,1 ,1 ,1 ,2 ,2 ,2 ,2 ,2 ,2 ,2 ,1 ,3 ,3 ,3 ,1 ,1 ,1 ,1 ,1 ,1 ,1 ],
  [1 ,1 ,1 ,1 ,1 ,1 ,1 ,1 ,2 ,1 ,1 ,1 ,1 ,1 ,2 ,2 ,2 ,2 ,2 ,1 ,1 ,1 ,1 ,3 ,2 ,2 ,1 ,1 ,2 ,2 ,2 ,2 ,2 ,2 ,2 ,2 ,2 ,1 ,2 ,2 ,2 ,2 ,2 ,2 ,1 ,1 ,1 ,1 ],
  [1 ,1 ,1 ,1 ,1 ,1 ,1 ,1 ,6 ,1 ,1 ,1 ,1 ,1 ,2 ,2 ,2 ,2 ,2 ,2 ,2 ,2 ,2 ,2 ,2 ,2 ,2 ,2 ,2 ,2 ,2 ,2 ,3 ,10,2 ,2 ,2 ,2 ,2 ,2 ,2 ,2 ,2 ,2 ,2 ,2 ,3 ,3 ],
  [1 ,1 ,1 ,1 ,1 ,1 ,1 ,1 ,3 ,1 ,1 ,1 ,1 ,1 ,2 ,2 ,2 ,2 ,2 ,2 ,2 ,2 ,2 ,2 ,2 ,10,10,2 ,2 ,2 ,2 ,1 ,1 ,13,10,2 ,2 ,2 ,2 ,2 ,1 ,1 ,1 ,2 ,2 ,2 ,2 ,3 ],
  [1 ,1 ,1 ,1 ,1 ,1 ,1 ,1 ,3 ,1 ,1 ,1 ,1 ,1 ,5 ,2 ,2 ,1 ,1 ,1 ,1 ,1 ,1 ,1 ,1 ,2 ,2 ,1 ,1 ,1 ,1 ,1 ,1 ,1 ,1 ,1 ,1 ,2 ,2 ,2 ,1 ,1 ,1 ,1 ,1 ,2 ,2 ,1 ],
  [1 ,1 ,1 ,1 ,1 ,1 ,1 ,1 ,3 ,1 ,1 ,1 ,1 ,1 ,1 ,1 ,1 ,1 ,1 ,1 ,1 ,1 ,1 ,1 ,1 ,9 ,11,1 ,1 ,1 ,1 ,1 ,1 ,1 ,1 ,1 ,1 ,1 ,1 ,2 ,2 ,1 ,1 ,1 ,2 ,2 ,2 ,1 ],
  [1 ,1 ,1 ,1 ,1 ,1 ,1 ,1 ,3 ,1 ,1 ,1 ,1 ,1 ,1 ,1 ,1 ,1 ,1 ,1 ,1 ,1 ,1 ,1 ,1 ,1 ,1 ,1 ,1 ,1 ,1 ,1 ,1 ,1 ,1 ,1 ,1 ,1 ,1 ,2 ,2 ,2 ,1 ,15,2 ,2 ,1 ,1 ],
  [1 ,1 ,1 ,1 ,1 ,1 ,1 ,1 ,7 ,1 ,1 ,1 ,1 ,1 ,2 ,2 ,2 ,2 ,2 ,2 ,2 ,2 ,2 ,2 ,1 ,1 ,1 ,1 ,1 ,2 ,2 ,2 ,2 ,2 ,2 ,1 ,1 ,1 ,1 ,2 ,2 ,2 ,2 ,2 ,2 ,1 ,1 ,1 ],
  [1 ,1 ,1 ,1 ,1 ,1 ,1 ,1 ,3 ,1 ,1 ,1 ,1 ,1 ,2 ,2 ,2 ,2 ,2 ,2 ,2 ,2 ,2 ,2 ,2 ,2 ,2 ,2 ,2 ,2 ,2 ,2 ,2 ,2 ,2 ,2 ,2 ,1 ,1 ,1 ,1 ,2 ,2 ,2 ,3 ,1 ,1 ,1 ],
  [1 ,1 ,1 ,1 ,1 ,1 ,1 ,1 ,3 ,1 ,1 ,1 ,1 ,1 ,2 ,2 ,2 ,2 ,2 ,2 ,2 ,2 ,2 ,2 ,2 ,2 ,2 ,2 ,2 ,2 ,2 ,2 ,2 ,2 ,2 ,2 ,2 ,2 ,2 ,1 ,1 ,2 ,2 ,3 ,3 ,1 ,1 ,1 ],
  [1 ,1 ,1 ,1 ,1 ,1 ,1 ,1 ,3 ,1 ,1 ,1 ,1 ,1 ,2 ,2 ,2 ,2 ,2 ,2 ,2 ,2 ,2 ,2 ,2 ,2 ,2 ,2 ,2 ,2 ,2 ,2 ,2 ,2 ,2 ,2 ,2 ,2 ,2 ,2 ,2 ,2 ,2 ,3 ,1 ,1 ,1 ,1 ],
  [1 ,1 ,1 ,1 ,1 ,1 ,1 ,1 ,3 ,1 ,1 ,1 ,1 ,1 ,1 ,1 ,1 ,1 ,1 ,1 ,1 ,1 ,1 ,1 ,2 ,2 ,2 ,2 ,2 ,1 ,1 ,1 ,1 ,1 ,1 ,2 ,2 ,2 ,2 ,2 ,2 ,2 ,2 ,3 ,1 ,1 ,1 ,1 ],
  [1 ,1 ,1 ,1 ,1 ,1 ,1 ,1 ,3 ,1 ,1 ,1 ,1 ,1 ,1 ,1 ,1 ,1 ,1 ,1 ,1 ,1 ,1 ,1 ,1 ,1 ,1 ,1 ,1 ,1 ,1 ,1 ,1 ,1 ,1 ,1 ,1 ,2 ,2 ,2 ,2 ,2 ,2 ,1 ,1 ,1 ,1 ,1 ],
  [1 ,1 ,1 ,1 ,1 ,1 ,1 ,1 ,3 ,1 ,1 ,1 ,1 ,1 ,1 ,1 ,1 ,1 ,1 ,1 ,1 ,1 ,1 ,1 ,1 ,1 ,1 ,1 ,1 ,1 ,1 ,1 ,1 ,1 ,1 ,1 ,1 ,1 ,1 ,1 ,1 ,1 ,1 ,1 ,1 ,1 ,1 ,1 ],
  [1 ,1 ,1 ,1 ,1 ,1 ,1 ,1 ,3 ,1 ,1 ,1 ,1 ,1 ,1 ,1 ,1 ,1 ,1 ,1 ,1 ,1 ,1 ,1 ,1 ,1 ,1 ,1 ,1 ,1 ,1 ,1 ,1 ,1 ,1 ,1 ,1 ,1 ,1 ,1 ,1 ,1 ,1 ,1 ,1 ,1 ,1 ,1 ]
]
