[
  [1 ,1 ,1 ,1 ,1 ,1 ,1 ,1 ,1 ,1 ,1 ,1 ,1 ,1 ,1 ,1 ,1 ,1 ,1 ,1 ,1 ,1 ,1 ,1 ,1 ,1 ,1 ,1 ,1 ,1 ,1 ,1 ,1 ,1 ,1 ,1 ,1 ,1 ,1 ,1 ,1 ,1 ,1 ,1 ,1 ,1 ,1 ,1 ],
  [1 ,1 ,1 ,1 ,1 ,1 ,1 ,1 ,1 ,1 ,2 ,2 ,2 ,2 ,2 ,2 ,2 ,2 ,2 ,2 ,2 ,2 ,2 ,1 ,1 ,1 ,1 ,1 ,1 ,1 ,1 ,1 ,1 ,1 ,1 ,1 ,1 ,1 ,1 ,1 ,1 ,1 ,1 ,1 ,1 ,1 ,1 ,1 ],
  [1 ,1 ,1 ,1 ,1 ,1 ,1 ,1 ,1 ,1 ,2 ,2 ,2 ,2 ,2 ,2 ,2 ,2 ,2 ,2 ,2 ,2 ,2 ,1 ,1 ,1 ,1 ,1 ,1 ,3 ,3 ,12,1 ,1 ,1 ,1 ,1 ,1 ,1 ,5 ,2 ,1 ,1 ,1 ,1 ,1 ,1 ,1 ],
  [1 ,1 ,1 ,1 ,1 ,1 ,1 ,1 ,1 ,1 ,3 ,2 ,1 ,1 ,1 ,1 ,1 ,1 ,8 ,8 ,8 ,8 ,8 ,3 ,1 ,1 ,1 ,1 ,9 ,3 ,2 ,2 ,2 ,2 ,1 ,1 ,4 ,2 ,2 ,2 ,2 ,2 ,2 ,2 ,1 ,1 ,1 ,1 ],
  [1 ,1 ,1 ,1 ,1 ,1 ,1 ,1 ,1 ,3 ,3 ,2 ,2 ,1 ,1 ,1 ,1 ,2 ,2 ,2 ,2 ,2 ,2 ,3 ,3 ,1 ,1 ,1 ,1 ,9 ,10,2 ,2 ,2 ,2 ,2 ,2 ,2 ,2 ,2 ,2 ,3 ,2 ,2 ,1 ,1 ,1 ,1 ],
  [1 ,1 ,1 ,1 ,1 ,1 ,1 ,1 ,1 ,3 ,2 ,2 ,2 ,2 ,1 ,1 ,1 ,2 ,2 ,2 ,2 ,2 ,2 ,2 ,10,13,1 ,1 ,1 ,10,2 ,2 ,2 ,2 ,2 ,2 ,2 ,3 ,2 ,2 ,1 ,14,14,14,1 ,1 ,1 ,1 ],
  [1 ,1 ,1 ,1 ,1 ,1 ,1 ,1 ,1 ,1 ,2 ,2 ,2 ,2 ,1 ,1 ,1 ,1 ,3 ,2 ,2 ,2 ,2 ,2 ,10,9 ,1 ,1 ,1 ,1 ,1 ,2 ,2 ,2 ,2 ,3 ,1 ,1 ,1 ,1 ,1 ,3 ,3 ,13,1 ,1 ,1 ,1 ],
  [1 ,1 ,1 ,1 ,1 ,1 ,1 ,1 ,1 ,1 ,1 ,2 ,2 ,2 ,1 ,1 ,1 ,5 ,3 ,3 ,2 ,1 ,1 ,2 ,10,10,1 ,1 ,1 ,1 ,1 ,2 ,2 ,2 ,3 ,1 ,1 ,1 ,1 ,1 ,1 ,3 ,3 ,3 ,13,1 ,1 ,1 ],
  [1 ,1 ,1 ,1 ,1 ,1 ,1 ,1 ,1 ,2 ,2 ,2 ,2 ,2 ,1 ,1 ,1 ,3 ,3 ,3 ,2 ,1 ,1 ,2 ,2 ,2 ,1 ,1 ,1 ,1 ,1 ,2 ,2 ,2 ,1 ,1 ,1 ,1 ,1 ,3 ,3 ,13,13,3 ,3 ,1 ,1 ,1 ],
  [1 ,1 ,1 ,2 ,2 ,1 ,1 ,1 ,2 ,2 ,2 ,2 ,2 ,4 ,1 ,1 ,1 ,3 ,2 ,2 ,2 ,2 ,2 ,2 ,2 ,2 ,1 ,1 ,1 ,1 ,3 ,2 ,2 ,1 ,1 ,1 ,1 ,1 ,1 ,13,13,3 ,3 ,3 ,3 ,3 ,1 ,1 ],
  [1 ,1 ,2 ,2 ,2 ,1 ,1 ,2 ,2 ,2 ,2 ,1 ,1 ,1 ,1 ,1 ,1 ,2 ,2 ,2 ,10,2 ,2 ,2 ,2 ,2 ,1 ,1 ,1 ,1 ,3 ,2 ,2 ,2 ,2 ,1 ,1 ,1 ,1 ,1 ,13,13,13,3 ,3 ,3 ,1 ,1 ],
  [1 ,1 ,3 ,3 ,2 ,2 ,2 ,2 ,2 ,2 ,1 ,1 ,1 ,1 ,1 ,1 ,1 ,2 ,2 ,10,9 ,1 ,1 ,2 ,2 ,2 ,1 ,1 ,1 ,1 ,3 ,2 ,2 ,2 ,2 ,1 ,1 ,1 ,1 ,1 ,1 ,13,13,3 ,13,1 ,1 ,1 ],
  [1 ,1 ,3 ,2 ,2 ,2 ,2 ,2 ,2 ,1 ,1 ,1 ,1 ,1 ,1 ,2 ,2 ,2 ,10,9 ,1 ,1 ,1 ,2 ,2 ,2 ,1 ,1 ,1 ,1 ,2 ,2 ,1 ,2 ,2 ,2 ,1 ,1 ,1 ,3 ,1 ,1 ,1 ,13,3 ,1 ,1 ,1 ],
  [1 ,1 ,2 ,2 ,1 ,1 ,1 ,1 ,2 ,1 ,1 ,1 ,1 ,1 ,2 ,2 ,2 ,2 ,2 ,1 ,1 ,1 ,1 ,3 ,2 ,2 ,1 ,1 ,1 ,1 ,2 ,2 ,1 ,2 ,2 ,2 ,2 ,1 ,3 ,3 ,3 ,1 ,1 ,1 ,1 ,1 ,1 ,1 ],
  [1 ,1 ,1 ,1 ,1 ,1 ,1 ,1 ,2 ,1 ,1 ,1 ,1 ,1 ,2 ,2 ,2 ,2 ,2 ,1 ,1 ,1 ,1 ,3 ,2 ,2 ,1 ,1 ,2 ,2 ,2 ,2 ,2 ,2 ,2 ,2 ,2 ,1 ,2 ,2 ,2 ,2 ,2 ,5 ,1 ,1 ,1 ,1 ],
  [1 ,1 ,1 ,1 ,1 ,1 ,1 ,1 ,6 ,1 ,1 ,1 ,1 ,1 ,2 ,2 ,2 ,2 ,2 ,2 ,2 ,2 ,2 ,2 ,2 ,2 ,2 ,2 ,2 ,2 ,2 ,2 ,3 ,10,2 ,2 ,2 ,2 ,2 ,2 ,2 ,2 ,2 ,2 ,2 ,2 ,3 ,3 ],
  [1 ,1 ,1 ,1 ,1 ,1 ,1 ,1 ,3 ,1 ,1 ,1 ,1 ,1 ,2 ,2 ,2 ,2 ,2 ,2 ,2 ,2 ,2 ,2 ,2 ,10,10,2 ,2 ,2 ,2 ,1 ,1 ,13,10,2 ,2 ,2 ,2 ,2 ,1 ,1 ,1 ,2 ,2 ,2 ,2 ,3 ],
  [1 ,1 ,1 ,1 ,1 ,1 ,1 ,1 ,3 ,1 ,1 ,1 ,1 ,1 ,5 ,2 ,2 ,1 ,1 ,1 ,1 ,1 ,1 ,1 ,1 ,2 ,2 ,1 ,1 ,1 ,1 ,1 ,1 ,1 ,1 ,1 ,1 ,3 ,3 ,2 ,1 ,1 ,1 ,1 ,1 ,2 ,2 ,1 ],
  [1 ,1 ,1 ,1 ,1 ,1 ,1 ,1 ,3 ,1 ,1 ,1 ,1 ,1 ,1 ,1 ,1 ,1 ,1 ,1 ,1 ,1 ,1 ,1 ,1 ,9 ,11,1 ,1 ,1 ,1 ,1 ,1 ,1 ,1 ,1 ,1 ,1 ,1 ,2 ,2 ,1 ,1 ,1 ,2 ,2 ,2 ,1 ],
  [1 ,1 ,1 ,1 ,1 ,1 ,1 ,1 ,3 ,1 ,1 ,1 ,1 ,1 ,1 ,1 ,1 ,1 ,1 ,1 ,1 ,1 ,1 ,1 ,1 ,1 ,1 ,1 ,1 ,1 ,1 ,1 ,1 ,1 ,1 ,1 ,1 ,1 ,1 ,2 ,2 ,2 ,1 ,15,2 ,2 ,1 ,1 ],
  [1 ,1 ,1 ,1 ,1 ,1 ,1 ,1 ,7 ,1 ,1 ,1 ,1 ,1 ,1 ,1 ,1 ,1 ,1 ,2 ,24,23,23,22,1 ,1 ,1 ,1 ,1 ,1 ,1 ,2 ,2 ,2 ,3 ,1 ,1 ,1 ,1 ,2 ,2 ,2 ,2 ,2 ,2 ,1 ,1 ,1 ],
  [1 ,1 ,1 ,1 ,1 ,1 ,1 ,1 ,3 ,1 ,1 ,1 ,1 ,1 ,1 ,1 ,1 ,2 ,2 ,2 ,2 ,22,23,22,23,23,23,22,21,2 ,2 ,2 ,2 ,2 ,2 ,2 ,20,1 ,1 ,1 ,1 ,2 ,2 ,2 ,3 ,2 ,1 ,1 ],
  [1 ,1 ,1 ,1 ,1 ,1 ,1 ,1 ,3 ,1 ,1 ,1 ,1 ,1 ,1 ,3 ,2 ,2 ,2 ,2 ,2 ,22,23,23,23,22,23,22,2 ,2 ,2 ,2 ,2 ,2 ,2 ,2 ,20,3 ,3 ,1 ,1 ,2 ,2 ,3 ,3 ,2 ,1 ,1 ],
  [1 ,1 ,1 ,1 ,1 ,1 ,1 ,1 ,3 ,1 ,1 ,1 ,1 ,1 ,3 ,2 ,2 ,2 ,10,2 ,2 ,22,22,22,22,22,23,22,2 ,2 ,2 ,2 ,2 ,2 ,2 ,2 ,20,2 ,2 ,2 ,1 ,10,2 ,1 ,2 ,2 ,1 ,1 ],
  [1 ,1 ,1 ,1 ,1 ,1 ,1 ,1 ,29,1 ,1 ,1 ,1 ,1 ,3 ,2 ,2 ,10,9 ,1 ,1 ,1 ,22,22,22,22,23,23,2 ,2 ,1 ,1 ,1 ,1 ,1 ,2 ,20,2 ,2 ,2 ,1 ,9 ,10,1 ,2 ,2 ,1 ,1 ],
  [1 ,1 ,1 ,1 ,1 ,1 ,1 ,1 ,30,1 ,1 ,1 ,1 ,1 ,10,10 ,9,1 ,1 ,1 ,1 ,1 ,1 ,1 ,1 ,1 ,1 ,1 ,1 ,1 ,1 ,1 ,1 ,1 ,1 ,1 ,1 ,3 ,2 ,2 ,2 ,10,2 ,2 ,2 ,10,1 ,1 ],
  [1 ,1 ,1 ,1 ,1 ,1 ,1 ,1 ,31,1 ,1 ,1 ,1 ,1 ,3 ,2 ,2 ,1 ,1 ,1 ,1 ,1 ,1 ,1 ,1 ,1 ,1 ,1 ,1 ,1 ,1 ,1 ,1 ,1 ,1 ,1 ,1 ,1 ,2 ,2 ,2 ,2 ,2 ,2 ,10,9 ,1 ,1 ],
  [1 ,1 ,1 ,1 ,1 ,1 ,1 ,1 ,25,1 ,1 ,1 ,1 ,1 ,1 ,2 ,2 ,2 ,1 ,1 ,1 ,1 ,1 ,1 ,1 ,1 ,1 ,1 ,1 ,1 ,1 ,1 ,1 ,1 ,1 ,1 ,1 ,1 ,1 ,2 ,2 ,2 ,2 ,16,5 ,1 ,1 ,1 ],
  [1 ,1 ,1 ,1 ,1 ,1 ,1 ,5 ,3 ,2 ,19,1 ,1 ,1 ,1 ,2 ,2 ,2 ,2 ,3 ,1 ,1 ,1 ,1 ,1 ,1 ,1 ,1 ,1 ,1 ,1 ,1 ,1 ,1 ,1 ,1 ,1 ,1 ,1 ,1 ,2 ,2 ,1 ,1 ,1 ,1 ,1 ,1 ],
  [1 ,1 ,1 ,1 ,1 ,1 ,1 ,5 ,3 ,2 ,4 ,1 ,1 ,1 ,1 ,1 ,18,2 ,2 ,2 ,3 ,1 ,1 ,1 ,1 ,1 ,1 ,1 ,1 ,1 ,1 ,1 ,1 ,1 ,1 ,1 ,1 ,1 ,1 ,1 ,1 ,1 ,1 ,1 ,1 ,1 ,1 ,1 ],
  [1 ,1 ,1 ,1 ,1 ,1 ,1 ,5 ,3 ,2 ,2 ,1 ,1 ,1 ,1 ,1 ,1 ,5 ,2 ,2 ,2 ,3 ,1 ,1 ,1 ,1 ,3 ,3 ,1 ,1 ,1 ,1 ,5 ,1 ,1 ,1 ,1 ,1 ,1 ,1 ,1 ,1 ,1 ,1 ,1 ,1 ,1 ,1 ],
  [1 ,1 ,1 ,1 ,1 ,1 ,1 ,5 ,2 ,2 ,2 ,1 ,1 ,1 ,2 ,1 ,1 ,1 ,1 ,1 ,2 ,2 ,1 ,1 ,1 ,1 ,3 ,3 ,2 ,1 ,1 ,2 ,2 ,2 ,2 ,2 ,2 ,2 ,1 ,1 ,1 ,1 ,1 ,1 ,1 ,1 ,1 ,1 ],
  [1 ,1 ,1 ,1 ,1 ,1 ,1 ,5 ,2 ,2 ,2 ,1 ,1 ,3 ,2 ,13,13,1 ,1 ,1 ,1 ,2 ,2 ,1 ,1 ,1 ,1 ,3 ,2 ,2 ,2 ,2 ,2 ,2 ,2 ,35,35,35,2 ,2 ,2 ,1 ,1 ,1 ,1 ,1 ,1 ,1 ],
  [1 ,1 ,1 ,1 ,1 ,1 ,1 ,1 ,2 ,2 ,4 ,1 ,1 ,2 ,2 ,2 ,2 ,3 ,1 ,1 ,1 ,2 ,2 ,1 ,1 ,1 ,1 ,2 ,2 ,2 ,2 ,3 ,2 ,1 ,35,2 ,2 ,2 ,2 ,2 ,2 ,1 ,1 ,1 ,1 ,1 ,1 ,1 ],
  [1 ,1 ,1 ,1 ,1 ,1 ,1 ,13,2 ,1 ,1 ,1 ,1 ,2 ,2 ,1 ,2 ,2 ,3 ,3 ,1 ,2 ,2 ,1 ,1 ,1 ,2 ,2 ,2 ,2 ,3 ,1 ,1 ,1 ,1 ,34,34,34,34,34,34,1 ,1 ,1 ,1 ,1 ,1 ,1 ],
  [1 ,1 ,1 ,1 ,1 ,1 ,13,13,1 ,1 ,1 ,1 ,3 ,2 ,1 ,1 ,3 ,2 ,2 ,2 ,2 ,2 ,2 ,2 ,2 ,2 ,2 ,2 ,2 ,2 ,1 ,1 ,1 ,1 ,1 ,31,27,29,31,27,29,1 ,1 ,1 ,1 ,1 ,1 ,1 ],
  [1 ,1 ,1 ,1 ,1 ,1 ,13,13,1 ,1 ,1 ,1 ,3 ,2 ,2 ,1 ,1 ,1 ,2 ,2 ,2 ,2 ,2 ,2 ,2 ,2 ,3 ,3 ,2 ,1 ,1 ,1 ,1 ,1 ,1 ,30,26,28,30,26,28,1 ,1 ,1 ,1 ,1 ,1 ,1 ],
  [1 ,1 ,1 ,1 ,1 ,1 ,1 ,13,13,1 ,1 ,1 ,1 ,2 ,2 ,2 ,3 ,1 ,1 ,1 ,3 ,3 ,2 ,17,1 ,3 ,3 ,2 ,2 ,1 ,1 ,1 ,1 ,1 ,1 ,29,31,27,29,31,27,1 ,1 ,1 ,1 ,1 ,1 ,1 ],
  [1 ,1 ,1 ,1 ,1 ,1 ,1 ,3 ,3 ,3 ,1 ,1 ,1 ,1 ,1 ,2 ,3 ,1 ,1 ,1 ,1 ,3 ,2 ,1 ,1 ,1 ,1 ,2 ,2 ,1 ,1 ,1 ,1 ,33,3 ,28,30,26,28,30,29,3 ,33,1 ,1 ,1 ,1 ,1 ],
  [1 ,1 ,1 ,1 ,1 ,1 ,1 ,1 ,1 ,3 ,3 ,3 ,3 ,3 ,2 ,2 ,3 ,1 ,1 ,1 ,1 ,1 ,2 ,2 ,2 ,2 ,2 ,2 ,3 ,1 ,1 ,1 ,3 ,33,3 ,27,29,31,27,29,31,3 ,33,1 ,1 ,1 ,1 ,1 ],
  [1 ,1 ,1 ,1 ,1 ,1 ,1 ,1 ,1 ,9 ,3 ,3 ,2 ,2 ,2 ,2 ,1 ,1 ,1 ,1 ,1 ,1 ,5 ,2 ,2 ,2 ,2 ,3 ,1 ,1 ,1 ,1 ,3 ,33,1 ,26,28,30,26,28,30,1 ,33,3 ,1 ,1 ,1 ,1 ],
  [1 ,1 ,1 ,1 ,1 ,1 ,1 ,1 ,1 ,1 ,1 ,1 ,1 ,1 ,1 ,1 ,1 ,1 ,1 ,1 ,1 ,1 ,1 ,1 ,1 ,4 ,1 ,1 ,1 ,1 ,1 ,1 ,3 ,1 ,1 ,1 ,1 ,1 ,1 ,1 ,1 ,1 ,1 ,3 ,1 ,1 ,1 ,1 ],
  [1 ,1 ,1 ,1 ,1 ,1 ,1 ,1 ,1 ,1 ,1 ,1 ,1 ,1 ,1 ,1 ,1 ,1 ,1 ,1 ,1 ,1 ,1 ,1 ,1 ,1 ,1 ,1 ,1 ,1 ,1 ,1 ,3 ,3 ,1 ,26,27,30,29,28,26,1 ,3 ,3 ,1 ,1 ,1 ,1 ],
  [1 ,1 ,1 ,1 ,1 ,1 ,1 ,1 ,1 ,1 ,1 ,1 ,1 ,1 ,1 ,1 ,1 ,1 ,1 ,1 ,1 ,1 ,1 ,1 ,1 ,1 ,1 ,1 ,1 ,1 ,1 ,1 ,3 ,3 ,3 ,27,28,32,3 ,27,27,3 ,3 ,3 ,1 ,1 ,1 ,1 ],
  [1 ,1 ,1 ,1 ,1 ,1 ,1 ,1 ,1 ,1 ,1 ,1 ,1 ,1 ,1 ,1 ,1 ,1 ,1 ,1 ,1 ,1 ,1 ,1 ,1 ,1 ,1 ,1 ,1 ,1 ,1 ,1 ,1 ,3 ,3 ,28,3 ,30,31,26,28,3 ,3 ,1 ,1 ,1 ,1 ,1 ],
  [1 ,1 ,1 ,1 ,1 ,1 ,1 ,1 ,1 ,1 ,1 ,1 ,1 ,1 ,1 ,1 ,1 ,1 ,1 ,1 ,1 ,1 ,1 ,1 ,1 ,1 ,1 ,1 ,1 ,1 ,1 ,1 ,1 ,1 ,1 ,29,30,31,31,3 ,29,1 ,1 ,1 ,1 ,1 ,1 ,1 ],
  [1 ,1 ,1 ,1 ,1 ,1 ,1 ,1 ,1 ,1 ,1 ,1 ,1 ,1 ,1 ,1 ,1 ,1 ,1 ,1 ,1 ,1 ,1 ,1 ,1 ,1 ,1 ,1 ,1 ,1 ,1 ,1 ,1 ,1 ,1 ,30,32,30,27,28,29,30,31,3 ,1 ,1 ,1 ,1 ],
  [1 ,1 ,1 ,1 ,1 ,1 ,1 ,1 ,1 ,1 ,1 ,1 ,1 ,1 ,1 ,1 ,1 ,1 ,1 ,1 ,1 ,1 ,1 ,1 ,1 ,1 ,1 ,1 ,1 ,1 ,1 ,1 ,1 ,1 ,1 ,31,3 ,29,3 ,31,30,1 ,3 ,1 ,1 ,1 ,1 ,1 ],
  [1 ,1 ,1 ,1 ,1 ,1 ,1 ,1 ,1 ,1 ,1 ,1 ,1 ,1 ,1 ,1 ,1 ,1 ,1 ,1 ,1 ,1 ,1 ,1 ,1 ,1 ,1 ,1 ,1 ,1 ,1 ,1 ,1 ,1 ,1 ,1 ,3 ,3 ,1 ,3 ,3 ,1 ,1 ,1 ,1 ,1 ,1 ,1 ],
  [1 ,1 ,1 ,1 ,1 ,1 ,1 ,1 ,1 ,1 ,1 ,1 ,1 ,1 ,1 ,1 ,1 ,1 ,1 ,1 ,1 ,1 ,1 ,1 ,1 ,1 ,1 ,1 ,1 ,1 ,1 ,1 ,1 ,1 ,1 ,1 ,36,36,36,36,36,1 ,1 ,1 ,1 ,1 ,1 ,1 ],
  [1 ,1 ,1 ,1 ,1 ,1 ,1 ,1 ,1 ,1 ,1 ,1 ,1 ,1 ,1 ,1 ,1 ,1 ,1 ,1 ,1 ,1 ,1 ,1 ,1 ,1 ,1 ,1 ,1 ,1 ,1 ,1 ,1 ,1 ,1 ,1 ,1 ,2 ,2 ,2 ,2 ,1 ,1 ,1 ,1 ,1 ,1 ,1 ],
  [1 ,1 ,1 ,1 ,1 ,1 ,1 ,1 ,1 ,1 ,1 ,1 ,1 ,1 ,1 ,1 ,1 ,1 ,1 ,1 ,1 ,1 ,1 ,1 ,1 ,1 ,1 ,1 ,1 ,1 ,1 ,1 ,1 ,1 ,1 ,1 ,1 ,2 ,2 ,2 ,2 ,1 ,1 ,1 ,1 ,1 ,1 ,1 ],
  [1 ,1 ,1 ,1 ,1 ,1 ,1 ,1 ,1 ,1 ,1 ,1 ,1 ,1 ,1 ,1 ,1 ,1 ,1 ,1 ,1 ,1 ,1 ,1 ,1 ,1 ,1 ,1 ,1 ,1 ,1 ,1 ,1 ,1 ,1 ,1 ,1 ,1 ,1 ,1 ,1 ,1 ,1 ,1 ,1 ,1 ,1 ,1 ]
]
