[
  [1 ,1 ,1 ,1 ,1 ,1 ,1 ,1 ,1 ,1 ,1 ,1 ,1 ,1 ,1 ,1 ,1 ,1 ,1 ,1 ,1 ,1 ,1 ,1 ,1 ,1 ,1 ,1 ,1 ,1 ,1 ,1 ,1 ,1 ,1 ,1 ,1 ,1 ,1 ,1 ,1 ,1 ,1 ,1 ,1 ,1 ],
  [1 ,1 ,1 ,1 ,1 ,1 ,1 ,1 ,1 ,1 ,2 ,2 ,2 ,2 ,2 ,2 ,2 ,2 ,2 ,2 ,2 ,2 ,2 ,1 ,1 ,1 ,1 ,1 ,1 ,1 ,1 ,1 ,1 ,1 ,1 ,1 ,1 ,1 ,1 ,1 ,1 ,1 ,1 ,1 ,1 ,1 ],
  [1 ,1 ,1 ,1 ,1 ,1 ,1 ,1 ,1 ,1 ,2 ,2 ,2 ,2 ,2 ,2 ,2 ,2 ,2 ,2 ,2 ,2 ,2 ,1 ,1 ,1 ,1 ,1 ,1 ,1 ,1 ,1 ,1 ,1 ,1 ,1 ,1 ,1 ,1 ,1 ,1 ,1 ,1 ,1 ,1 ,1 ],
  [1 ,1 ,1 ,1 ,1 ,1 ,1 ,1 ,1 ,1 ,3 ,2 ,1 ,1 ,1 ,1 ,1 ,1 ,8 ,8 ,8 ,8 ,8 ,3 ,1 ,1 ,1 ,1 ,1 ,1 ,1 ,1 ,1 ,1 ,1 ,1 ,1 ,1 ,1 ,1 ,1 ,1 ,1 ,1 ,1 ,1 ],
  [1 ,1 ,1 ,1 ,1 ,1 ,1 ,1 ,1 ,3 ,3 ,2 ,2 ,1 ,1 ,1 ,1 ,2 ,2 ,2 ,2 ,2 ,2 ,3 ,3 ,1 ,1 ,1 ,1 ,1 ,1 ,1 ,1 ,1 ,1 ,1 ,1 ,1 ,1 ,1 ,1 ,1 ,1 ,1 ,1 ,1 ],
  [1 ,1 ,1 ,1 ,1 ,1 ,1 ,1 ,1 ,3 ,2 ,2 ,2 ,2 ,1 ,1 ,1 ,2 ,2 ,2 ,2 ,2 ,2 ,2 ,10,9 ,1 ,1 ,1 ,1 ,1 ,1 ,1 ,1 ,1 ,1 ,1 ,1 ,1 ,1 ,1 ,1 ,1 ,1 ,1 ,1 ],
  [1 ,1 ,1 ,1 ,1 ,1 ,1 ,1 ,1 ,1 ,2 ,2 ,2 ,2 ,1 ,1 ,1 ,1 ,3 ,2 ,2 ,2 ,2 ,2 ,10,9 ,1 ,1 ,1 ,1 ,1 ,1 ,1 ,1 ,1 ,1 ,1 ,1 ,1 ,1 ,1 ,1 ,1 ,1 ,1 ,1 ],
  [1 ,1 ,1 ,1 ,1 ,1 ,1 ,1 ,1 ,1 ,1 ,2 ,2 ,2 ,1 ,1 ,1 ,5 ,3 ,3 ,2 ,1 ,1 ,2 ,10,10,1 ,1 ,1 ,1 ,1 ,1 ,1 ,1 ,1 ,1 ,1 ,1 ,1 ,1 ,1 ,1 ,1 ,1 ,1 ,1 ],
  [1 ,1 ,1 ,1 ,1 ,1 ,1 ,1 ,1 ,2 ,2 ,2 ,2 ,2 ,1 ,1 ,1 ,3 ,3 ,3 ,2 ,1 ,1 ,2 ,2 ,2 ,1 ,1 ,1 ,1 ,1 ,1 ,1 ,1 ,1 ,1 ,1 ,1 ,1 ,1 ,1 ,1 ,1 ,1 ,1 ,1 ],
  [1 ,1 ,1 ,2 ,2 ,1 ,1 ,1 ,2 ,2 ,2 ,2 ,2 ,4 ,1 ,1 ,1 ,3 ,2 ,2 ,2 ,2 ,2 ,2 ,2 ,2 ,1 ,1 ,1 ,1 ,2 ,2 ,2 ,1 ,1 ,1 ,1 ,1 ,1 ,1 ,1 ,1 ,1 ,1 ,1 ,1 ],
  [1 ,1 ,2 ,2 ,2 ,1 ,1 ,2 ,2 ,2 ,2 ,1 ,1 ,1 ,1 ,1 ,1 ,2 ,2 ,2 ,10,2 ,2 ,2 ,2 ,2 ,1 ,1 ,1 ,1 ,2 ,2 ,2 ,2 ,2 ,1 ,1 ,1 ,1 ,1 ,1 ,1 ,1 ,1 ,1 ,1 ],
  [1 ,1 ,3 ,3 ,2 ,2 ,2 ,2 ,2 ,2 ,1 ,1 ,1 ,1 ,1 ,1 ,1 ,2 ,2 ,10,9 ,1 ,1 ,2 ,2 ,2 ,1 ,1 ,1 ,1 ,2 ,2 ,2 ,2 ,2 ,1 ,1 ,1 ,1 ,1 ,1 ,1 ,1 ,1 ,1 ,1 ],
  [1 ,1 ,3 ,2 ,2 ,2 ,2 ,2 ,2 ,1 ,1 ,1 ,1 ,1 ,1 ,2 ,2 ,2 ,10,9 ,1 ,1 ,1 ,2 ,2 ,2 ,1 ,1 ,1 ,1 ,2 ,2 ,2 ,2 ,2 ,1 ,1 ,1 ,1 ,1 ,1 ,1 ,1 ,1 ,1 ,1 ],
  [1 ,1 ,2 ,2 ,1 ,1 ,1 ,1 ,2 ,1 ,1 ,1 ,1 ,1 ,2 ,2 ,2 ,2 ,2 ,1 ,1 ,1 ,1 ,3 ,2 ,2 ,1 ,1 ,1 ,1 ,2 ,2 ,2 ,2 ,2 ,1 ,1 ,1 ,1 ,1 ,1 ,1 ,1 ,1 ,1 ,1 ],
  [1 ,1 ,1 ,1 ,1 ,1 ,1 ,1 ,2 ,1 ,1 ,1 ,1 ,1 ,2 ,2 ,2 ,2 ,2 ,1 ,1 ,1 ,1 ,3 ,2 ,2 ,1 ,1 ,2 ,2 ,2 ,2 ,2 ,2 ,2 ,1 ,1 ,1 ,1 ,1 ,1 ,1 ,1 ,1 ,1 ,1 ],
  [1 ,1 ,1 ,1 ,1 ,1 ,1 ,1 ,6 ,1 ,1 ,1 ,1 ,1 ,2 ,2 ,2 ,2 ,2 ,2 ,2 ,2 ,2 ,2 ,2 ,2 ,2 ,2 ,2 ,2 ,2 ,2 ,2 ,2 ,2 ,1 ,1 ,1 ,1 ,1 ,1 ,1 ,1 ,1 ,1 ,1 ],
  [1 ,1 ,1 ,1 ,1 ,1 ,1 ,1 ,3 ,1 ,1 ,1 ,1 ,1 ,2 ,2 ,2 ,2 ,2 ,2 ,2 ,2 ,2 ,2 ,2 ,10,10,2 ,2 ,2 ,2 ,1 ,1 ,2 ,2 ,1 ,1 ,1 ,1 ,1 ,1 ,1 ,1 ,1 ,1 ,1 ],
  [1 ,1 ,1 ,1 ,1 ,1 ,1 ,1 ,3 ,1 ,1 ,1 ,1 ,1 ,5 ,2 ,2 ,1 ,1 ,1 ,1 ,1 ,1 ,1 ,1 ,2 ,2 ,1 ,1 ,1 ,1 ,1 ,1 ,1 ,1 ,1 ,1 ,1 ,1 ,1 ,1 ,1 ,1 ,1 ,1 ,1 ],
  [1 ,1 ,1 ,1 ,1 ,1 ,1 ,1 ,3 ,1 ,1 ,1 ,1 ,1 ,1 ,1 ,1 ,1 ,1 ,1 ,1 ,1 ,1 ,1 ,1 ,9 ,11,1 ,1 ,1 ,1 ,1 ,1 ,1 ,1 ,1 ,1 ,1 ,1 ,1 ,1 ,1 ,1 ,1 ,1 ,1 ],
  [1 ,1 ,1 ,1 ,1 ,1 ,1 ,1 ,3 ,1 ,1 ,1 ,1 ,1 ,1 ,1 ,1 ,1 ,1 ,1 ,1 ,1 ,1 ,1 ,1 ,1 ,1 ,1 ,1 ,1 ,1 ,1 ,1 ,1 ,1 ,1 ,1 ,1 ,1 ,1 ,1 ,1 ,1 ,1 ,1 ,1 ],
  [1 ,1 ,1 ,1 ,1 ,1 ,1 ,1 ,7 ,1 ,1 ,1 ,1 ,1 ,1 ,1 ,1 ,1 ,1 ,1 ,1 ,1 ,1 ,1 ,1 ,1 ,1 ,1 ,1 ,1 ,1 ,1 ,1 ,1 ,1 ,1 ,1 ,1 ,1 ,1 ,1 ,1 ,1 ,1 ,1 ,1 ],
  [1 ,1 ,1 ,1 ,1 ,1 ,1 ,1 ,3 ,1 ,1 ,1 ,1 ,1 ,1 ,1 ,1 ,1 ,1 ,1 ,1 ,1 ,1 ,1 ,1 ,1 ,1 ,1 ,1 ,1 ,1 ,1 ,1 ,1 ,1 ,1 ,1 ,1 ,1 ,1 ,1 ,1 ,1 ,1 ,1 ,1 ],
  [1 ,1 ,1 ,1 ,1 ,1 ,1 ,1 ,3 ,1 ,1 ,1 ,1 ,1 ,1 ,1 ,1 ,1 ,1 ,1 ,1 ,1 ,1 ,1 ,1 ,1 ,1 ,1 ,1 ,1 ,1 ,1 ,1 ,1 ,1 ,1 ,1 ,1 ,1 ,1 ,1 ,1 ,1 ,1 ,1 ,1 ],
  [1 ,1 ,1 ,1 ,1 ,1 ,1 ,1 ,3 ,1 ,1 ,1 ,1 ,1 ,1 ,1 ,1 ,1 ,1 ,1 ,1 ,1 ,1 ,1 ,1 ,1 ,1 ,1 ,1 ,1 ,1 ,1 ,1 ,1 ,1 ,1 ,1 ,1 ,1 ,1 ,1 ,1 ,1 ,1 ,1 ,1 ]
]
