[
  [1 ,1 ,1 ,1 ,1 ,1 ,1 ,1 ,1 ,1 ,1 ,1 ,1 ,1 ,1 ,1 ,1 ,1 ,1 ,1 ,1 ,1 ,1 ,1 ,1 ,1 ,1 ,1 ,1 ,1 ,1 ,1 ,1 ,1 ,1 ,1 ,1 ,1 ,1 ,1 ,1 ,1 ,1 ,1 ,1 ,1 ,1 ,1 ],
  [1 ,1 ,1 ,1 ,1 ,1 ,1 ,1 ,1 ,1 ,2 ,2 ,2 ,2 ,2 ,2 ,2 ,2 ,2 ,2 ,2 ,2 ,2 ,1 ,1 ,1 ,1 ,1 ,1 ,1 ,1 ,1 ,1 ,1 ,1 ,1 ,1 ,1 ,1 ,1 ,1 ,1 ,1 ,1 ,1 ,1 ,1 ,1 ],
  [1 ,1 ,1 ,1 ,1 ,1 ,1 ,1 ,1 ,1 ,2 ,2 ,2 ,2 ,2 ,2 ,2 ,2 ,2 ,2 ,2 ,2 ,2 ,1 ,1 ,1 ,1 ,1 ,1 ,3 ,3 ,12,1 ,1 ,1 ,1 ,1 ,1 ,1 ,5 ,2 ,1 ,1 ,1 ,1 ,1 ,1 ,1 ],
  [1 ,1 ,1 ,1 ,1 ,1 ,1 ,1 ,1 ,1 ,3 ,2 ,1 ,1 ,1 ,1 ,1 ,1 ,8 ,8 ,8 ,8 ,8 ,3 ,1 ,1 ,1 ,1 ,9 ,3 ,2 ,2 ,2 ,2 ,1 ,1 ,4 ,2 ,2 ,2 ,2 ,2 ,2 ,2 ,1 ,1 ,1 ,1 ],
  [1 ,1 ,1 ,1 ,1 ,1 ,1 ,1 ,1 ,3 ,3 ,2 ,2 ,1 ,1 ,1 ,1 ,2 ,2 ,2 ,2 ,2 ,2 ,3 ,3 ,1 ,1 ,1 ,1 ,9 ,10,2 ,2 ,2 ,2 ,2 ,2 ,2 ,2 ,2 ,2 ,3 ,2 ,2 ,1 ,1 ,1 ,1 ],
  [1 ,1 ,1 ,1 ,1 ,1 ,1 ,1 ,1 ,3 ,2 ,2 ,2 ,2 ,1 ,1 ,1 ,2 ,2 ,2 ,2 ,2 ,2 ,2 ,10,13,1 ,1 ,1 ,10,2 ,2 ,2 ,2 ,2 ,2 ,2 ,3 ,2 ,2 ,1 ,14,14,14,1 ,1 ,1 ,1 ],
  [1 ,1 ,1 ,1 ,1 ,1 ,1 ,1 ,1 ,1 ,2 ,2 ,2 ,2 ,1 ,1 ,1 ,1 ,3 ,2 ,2 ,2 ,2 ,2 ,10,9 ,1 ,1 ,1 ,1 ,1 ,2 ,2 ,2 ,2 ,3 ,1 ,1 ,1 ,1 ,1 ,3 ,3 ,13,1 ,1 ,1 ,1 ],
  [1 ,1 ,1 ,1 ,1 ,1 ,1 ,1 ,1 ,1 ,1 ,2 ,2 ,2 ,1 ,1 ,1 ,5 ,3 ,3 ,2 ,1 ,1 ,2 ,10,10,1 ,1 ,1 ,1 ,1 ,2 ,2 ,2 ,3 ,1 ,1 ,1 ,1 ,1 ,1 ,3 ,3 ,3 ,13,1 ,1 ,1 ],
  [1 ,1 ,1 ,1 ,1 ,1 ,1 ,1 ,1 ,2 ,2 ,2 ,2 ,2 ,1 ,1 ,1 ,3 ,3 ,3 ,2 ,1 ,1 ,2 ,2 ,2 ,1 ,1 ,1 ,1 ,1 ,2 ,2 ,2 ,1 ,1 ,1 ,1 ,1 ,3 ,3 ,13,13,3 ,3 ,1 ,1 ,1 ],
  [1 ,1 ,1 ,2 ,2 ,1 ,1 ,1 ,2 ,2 ,2 ,2 ,2 ,4 ,1 ,1 ,1 ,3 ,2 ,2 ,2 ,2 ,2 ,2 ,2 ,2 ,1 ,1 ,1 ,1 ,3 ,2 ,2 ,1 ,1 ,1 ,1 ,1 ,1 ,13,13,3 ,3 ,3 ,3 ,3 ,1 ,1 ],
  [1 ,1 ,2 ,2 ,2 ,1 ,1 ,2 ,2 ,2 ,2 ,1 ,1 ,1 ,1 ,1 ,1 ,2 ,2 ,2 ,10,2 ,2 ,2 ,2 ,2 ,1 ,1 ,1 ,1 ,3 ,2 ,2 ,2 ,2 ,1 ,1 ,1 ,1 ,1 ,13,13,13,3 ,3 ,3 ,1 ,1 ],
  [1 ,1 ,3 ,3 ,2 ,2 ,2 ,2 ,2 ,2 ,1 ,1 ,1 ,1 ,1 ,1 ,1 ,2 ,2 ,10,9 ,1 ,1 ,2 ,2 ,2 ,1 ,1 ,1 ,1 ,3 ,2 ,2 ,2 ,2 ,1 ,1 ,1 ,1 ,1 ,1 ,13,13,3 ,13,1 ,1 ,1 ],
  [1 ,1 ,3 ,2 ,2 ,2 ,2 ,2 ,2 ,1 ,1 ,1 ,1 ,1 ,1 ,2 ,2 ,2 ,10,9 ,1 ,1 ,1 ,2 ,2 ,2 ,1 ,1 ,1 ,1 ,2 ,2 ,1 ,2 ,2 ,2 ,1 ,1 ,1 ,3 ,1 ,1 ,1 ,13,3 ,1 ,1 ,1 ],
  [1 ,1 ,2 ,2 ,1 ,1 ,1 ,1 ,2 ,1 ,1 ,1 ,1 ,1 ,2 ,2 ,2 ,2 ,2 ,1 ,1 ,1 ,1 ,3 ,2 ,2 ,1 ,1 ,1 ,1 ,2 ,2 ,1 ,2 ,2 ,2 ,2 ,1 ,3 ,3 ,3 ,1 ,1 ,1 ,1 ,1 ,1 ,1 ],
  [1 ,1 ,1 ,1 ,1 ,1 ,1 ,1 ,2 ,1 ,1 ,1 ,1 ,1 ,2 ,2 ,2 ,2 ,2 ,1 ,1 ,1 ,1 ,3 ,2 ,2 ,1 ,1 ,2 ,2 ,2 ,2 ,2 ,2 ,2 ,2 ,2 ,1 ,2 ,2 ,2 ,2 ,2 ,5 ,1 ,1 ,1 ,1 ],
  [1 ,1 ,1 ,1 ,1 ,1 ,1 ,1 ,6 ,1 ,1 ,1 ,1 ,1 ,2 ,2 ,2 ,2 ,2 ,2 ,2 ,2 ,2 ,2 ,2 ,2 ,2 ,2 ,2 ,2 ,2 ,2 ,3 ,10,2 ,2 ,2 ,2 ,2 ,2 ,2 ,2 ,2 ,2 ,2 ,2 ,3 ,3 ],
  [1 ,1 ,1 ,1 ,1 ,1 ,1 ,1 ,3 ,1 ,1 ,1 ,1 ,1 ,2 ,2 ,2 ,2 ,2 ,2 ,2 ,2 ,2 ,2 ,2 ,10,10,2 ,2 ,2 ,2 ,1 ,1 ,13,10,2 ,2 ,2 ,2 ,2 ,1 ,1 ,1 ,2 ,2 ,2 ,2 ,3 ],
  [1 ,1 ,1 ,1 ,1 ,1 ,1 ,1 ,3 ,1 ,1 ,1 ,1 ,1 ,5 ,2 ,2 ,1 ,1 ,1 ,1 ,1 ,1 ,1 ,1 ,2 ,2 ,1 ,1 ,1 ,1 ,1 ,1 ,1 ,1 ,1 ,1 ,3 ,3 ,2 ,1 ,1 ,1 ,1 ,1 ,2 ,2 ,1 ],
  [1 ,1 ,1 ,1 ,1 ,1 ,1 ,1 ,3 ,1 ,1 ,1 ,1 ,1 ,1 ,1 ,1 ,1 ,1 ,1 ,1 ,1 ,1 ,1 ,1 ,9 ,11,1 ,1 ,1 ,1 ,1 ,1 ,1 ,1 ,1 ,1 ,1 ,1 ,2 ,2 ,1 ,1 ,1 ,2 ,2 ,2 ,1 ],
  [1 ,1 ,1 ,1 ,1 ,1 ,1 ,1 ,3 ,1 ,1 ,1 ,1 ,1 ,1 ,1 ,1 ,1 ,1 ,1 ,1 ,1 ,1 ,1 ,1 ,1 ,1 ,1 ,1 ,1 ,1 ,1 ,1 ,1 ,1 ,1 ,1 ,1 ,1 ,2 ,2 ,2 ,1 ,15,2 ,2 ,1 ,1 ],
  [1 ,1 ,1 ,1 ,1 ,1 ,1 ,1 ,7 ,1 ,1 ,1 ,1 ,1 ,1 ,1 ,1 ,1 ,1 ,2 ,24,23,23,22,1 ,1 ,1 ,1 ,1 ,1 ,1 ,2 ,2 ,2 ,3 ,1 ,1 ,1 ,1 ,2 ,2 ,2 ,2 ,2 ,2 ,1 ,1 ,1 ],
  [1 ,1 ,1 ,1 ,1 ,1 ,1 ,1 ,3 ,1 ,1 ,1 ,1 ,1 ,1 ,1 ,1 ,2 ,2 ,2 ,2 ,22,23,22,23,23,23,22,21,2 ,2 ,2 ,2 ,2 ,2 ,2 ,20,1 ,1 ,1 ,1 ,2 ,2 ,2 ,3 ,2 ,1 ,1 ],
  [1 ,1 ,1 ,1 ,1 ,1 ,1 ,1 ,3 ,1 ,1 ,1 ,1 ,1 ,1 ,3 ,2 ,2 ,2 ,2 ,2 ,22,23,23,23,22,23,22,2 ,2 ,2 ,2 ,2 ,2 ,2 ,2 ,20,3 ,3 ,1 ,1 ,2 ,2 ,3 ,3 ,2 ,1 ,1 ],
  [1 ,1 ,1 ,1 ,1 ,1 ,1 ,1 ,3 ,1 ,1 ,1 ,1 ,1 ,3 ,2 ,2 ,2 ,10,2 ,2 ,22,22,22,22,22,23,22,2 ,2 ,2 ,2 ,2 ,2 ,2 ,2 ,20,2 ,2 ,2 ,1 ,10,2 ,1 ,2 ,2 ,1 ,1 ],
  [1 ,1 ,1 ,1 ,1 ,1 ,1 ,1 ,3 ,1 ,1 ,1 ,1 ,1 ,3 ,2 ,2 ,10,9 ,1 ,1 ,1 ,22,22,22,22,23,23,2 ,2 ,1 ,1 ,1 ,1 ,1 ,2 ,20,2 ,2 ,2 ,1 ,9 ,10,1 ,2 ,2 ,1 ,1 ],
  [1 ,1 ,1 ,1 ,1 ,1 ,1 ,1 ,3 ,1 ,1 ,1 ,1 ,1 ,10,10 ,9,1 ,1 ,1 ,1 ,1 ,1 ,1 ,1 ,1 ,1 ,1 ,1 ,1 ,1 ,1 ,1 ,1 ,1 ,1 ,1 ,3 ,2 ,2 ,2 ,10,2 ,2 ,2 ,10,1 ,1 ],
  [1 ,1 ,1 ,1 ,1 ,1 ,1 ,1 ,3 ,1 ,1 ,1 ,1 ,1 ,3 ,2 ,2 ,1 ,1 ,1 ,1 ,1 ,1 ,1 ,1 ,1 ,1 ,1 ,1 ,1 ,1 ,1 ,1 ,1 ,1 ,1 ,1 ,1 ,2 ,2 ,2 ,2 ,2 ,2 ,10,9 ,1 ,1 ],
  [1 ,1 ,1 ,1 ,1 ,1 ,1 ,1 ,25,1 ,1 ,1 ,1 ,1 ,1 ,2 ,2 ,2 ,1 ,1 ,1 ,1 ,1 ,1 ,1 ,1 ,1 ,1 ,1 ,1 ,1 ,1 ,1 ,1 ,1 ,1 ,1 ,1 ,1 ,2 ,2 ,2 ,2 ,16,5 ,1 ,1 ,1 ],
  [1 ,1 ,1 ,1 ,1 ,1 ,1 ,5 ,3 ,2 ,19,1 ,1 ,1 ,1 ,2 ,2 ,2 ,2 ,3 ,1 ,1 ,1 ,1 ,1 ,1 ,1 ,1 ,1 ,1 ,1 ,1 ,1 ,1 ,1 ,1 ,1 ,1 ,1 ,1 ,2 ,2 ,1 ,1 ,1 ,1 ,1 ,1 ],
  [1 ,1 ,1 ,1 ,1 ,1 ,1 ,5 ,3 ,2 ,4 ,1 ,1 ,1 ,1 ,1 ,18,2 ,2 ,2 ,3 ,1 ,1 ,1 ,1 ,1 ,1 ,1 ,1 ,1 ,1 ,1 ,1 ,1 ,1 ,1 ,1 ,1 ,1 ,1 ,1 ,1 ,1 ,1 ,1 ,1 ,1 ,1 ],
  [1 ,1 ,1 ,1 ,1 ,1 ,1 ,5 ,3 ,2 ,2 ,1 ,1 ,1 ,1 ,1 ,1 ,5 ,2 ,2 ,2 ,3 ,1 ,1 ,1 ,1 ,3 ,3 ,1 ,1 ,1 ,1 ,5 ,1 ,1 ,1 ,1 ,1 ,1 ,1 ,1 ,1 ,1 ,1 ,1 ,1 ,1 ,1 ],
  [1 ,1 ,1 ,1 ,1 ,1 ,1 ,5 ,2 ,2 ,2 ,1 ,1 ,1 ,2 ,1 ,1 ,1 ,1 ,1 ,2 ,2 ,1 ,1 ,1 ,1 ,3 ,3 ,2 ,1 ,1 ,2 ,2 ,2 ,2 ,2 ,2 ,2 ,1 ,1 ,1 ,1 ,1 ,1 ,1 ,1 ,1 ,1 ],
  [1 ,1 ,1 ,1 ,1 ,1 ,1 ,5 ,2 ,2 ,2 ,1 ,1 ,3 ,2 ,13,13,1 ,1 ,1 ,1 ,2 ,2 ,1 ,1 ,1 ,1 ,3 ,2 ,2 ,2 ,2 ,2 ,2 ,2 ,2 ,2 ,2 ,2 ,2 ,2 ,2 ,1 ,1 ,1 ,1 ,1 ,1 ],
  [1 ,1 ,1 ,1 ,1 ,1 ,1 ,1 ,2 ,2 ,4 ,1 ,1 ,2 ,2 ,2 ,2 ,3 ,1 ,1 ,1 ,2 ,2 ,1 ,1 ,1 ,1 ,2 ,2 ,2 ,2 ,3 ,2 ,1 ,2 ,2 ,2 ,2 ,2 ,2 ,2 ,2 ,1 ,1 ,1 ,1 ,1 ,1 ],
  [1 ,1 ,1 ,1 ,1 ,1 ,1 ,13,2 ,1 ,1 ,1 ,1 ,2 ,2 ,1 ,2 ,2 ,3 ,3 ,1 ,2 ,2 ,1 ,1 ,1 ,2 ,2 ,2 ,2 ,3 ,1 ,1 ,1 ,1 ,2 ,2 ,2 ,2 ,2 ,2 ,2 ,1 ,1 ,1 ,1 ,1 ,1 ],
  [1 ,1 ,1 ,1 ,1 ,1 ,13,13,1 ,1 ,1 ,1 ,3 ,2 ,1 ,1 ,3 ,2 ,2 ,2 ,2 ,2 ,2 ,2 ,2 ,2 ,2 ,2 ,2 ,2 ,1 ,1 ,1 ,1 ,1 ,2 ,2 ,2 ,2 ,2 ,2 ,2 ,1 ,1 ,1 ,1 ,1 ,1 ],
  [1 ,1 ,1 ,1 ,1 ,1 ,13,13,1 ,1 ,1 ,1 ,3 ,2 ,2 ,1 ,1 ,1 ,2 ,2 ,2 ,2 ,2 ,2 ,2 ,2 ,3 ,3 ,2 ,1 ,1 ,1 ,1 ,1 ,1 ,2 ,2 ,2 ,2 ,2 ,2 ,2 ,1 ,1 ,1 ,1 ,1 ,1 ],
  [1 ,1 ,1 ,1 ,1 ,1 ,1 ,13,13,1 ,1 ,1 ,1 ,2 ,2 ,2 ,3 ,1 ,1 ,1 ,3 ,3 ,2 ,17,1 ,3 ,3 ,2 ,2 ,1 ,1 ,1 ,1 ,1 ,1 ,2 ,2 ,2 ,2 ,2 ,2 ,2 ,1 ,1 ,1 ,1 ,1 ,1 ],
  [1 ,1 ,1 ,1 ,1 ,1 ,1 ,3 ,3 ,3 ,1 ,1 ,1 ,1 ,1 ,2 ,3 ,1 ,1 ,1 ,1 ,3 ,2 ,1 ,1 ,1 ,1 ,2 ,2 ,1 ,1 ,1 ,1 ,1 ,1 ,2 ,2 ,2 ,2 ,2 ,2 ,2 ,1 ,1 ,1 ,1 ,1 ,1 ],
  [1 ,1 ,1 ,1 ,1 ,1 ,1 ,1 ,1 ,3 ,3 ,3 ,3 ,3 ,2 ,2 ,3 ,1 ,1 ,1 ,1 ,1 ,2 ,2 ,2 ,2 ,2 ,2 ,3 ,1 ,1 ,1 ,1 ,1 ,1 ,2 ,2 ,2 ,2 ,2 ,2 ,2 ,1 ,1 ,1 ,1 ,1 ,1 ],
  [1 ,1 ,1 ,1 ,1 ,1 ,1 ,1 ,1 ,9 ,3 ,3 ,2 ,2 ,2 ,2 ,1 ,1 ,1 ,1 ,1 ,1 ,5 ,2 ,2 ,2 ,2 ,3 ,1 ,1 ,1 ,1 ,1 ,1 ,1 ,2 ,2 ,2 ,2 ,2 ,2 ,1 ,1 ,1 ,1 ,1 ,1 ,1 ],
  [1 ,1 ,1 ,1 ,1 ,1 ,1 ,1 ,1 ,1 ,1 ,1 ,1 ,1 ,1 ,1 ,1 ,1 ,1 ,1 ,1 ,1 ,1 ,1 ,1 ,4 ,1 ,1 ,1 ,1 ,1 ,1 ,1 ,1 ,1 ,1 ,1 ,1 ,1 ,1 ,1 ,1 ,1 ,1 ,1 ,1 ,1 ,1 ],
  [1 ,1 ,1 ,1 ,1 ,1 ,1 ,1 ,1 ,1 ,1 ,1 ,1 ,1 ,1 ,1 ,1 ,1 ,1 ,1 ,1 ,1 ,1 ,1 ,1 ,1 ,1 ,1 ,1 ,1 ,1 ,1 ,1 ,1 ,1 ,1 ,1 ,1 ,1 ,1 ,1 ,1 ,1 ,1 ,1 ,1 ,1 ,1 ]
]
